pos_control_pLlacO1	GGCGCGCCATAAATGTGAGCGGATAACAATTGACATTGTGAGCGGATAACAAGATACTGAGCACATCAGCATTGC
pos_control_apFAB62	GGCGCGCCTTGACAATTAATCATCCGGCTCGCATAATTATTTCATTTCAG
pos_control_apFAB63	GGCGCGCCTTGACAATTAATCATCCGGCTCGTAGATTTAACGTATAAAGC
pos_control_apFAB61	GGCGCGCCTTGACAATTAATCATCCGGCTCGTATAATAGATTCATTAGAG
pos_control_apFAB66	GGCGCGCCTTGACATCAGGAAAATTTTTCTGTATAATAGATTCATCTCAA
pos_control_apFAB67	GGCGCGCCTTGACATCAGGAAAATTTTTCTGCATAATTATTTCATATCAC
pos_control_apFAB64	GGCGCGCCTTGACATCAGGAAAATTTTTCTGATACTTACAGCCATACCTA
pos_control_apFAB65	GGCGCGCCTTGACATCAGGAAAATTTTTCTGTATAATGTGTGGATTCGTA
pos_control_apFAB68	GGCGCGCCTTGACATCAGGAAAATTTTTCTGTAGATTTAACGTATAGGTA
pos_control_apFAB69	GGCGCGCCTTGACATCGCATCTTTTTGTACCATACTTACAGCCATTGTAC
pos_control_galP1	GGCGCGCCTTTATTCCATGTCACACTTTTCGCATCTTTGTTATGCTATGGTTATTTCATACCATAATTCGA
pos_control_apFAB115	GGCGCGCCTCGACATCAGGAAAATTTTTCTGTATAATGTGTGGATCTACA
pos_control_apFAB114	GGCGCGCCTCGACATCAGGAAAATTTTTCTGATACTTACAGCCATGCGGA
pos_control_apFAB89	GGCGCGCCAAAAAATTTATTTGCTTTCAGGAAAATTTTTCTGATACTTACAGCCATATTAT
pos_control_J23101	GGCGCGCCTTTACAGCTAGCTCAGTCCTAGGTATTATGCTAGCCAGTT
pos_control_apFAB124	GGCGCGCCTCGACATTTATCCCTTGCGGCGAATACTTACAGCCATAGCAA
pos_control_apFAB125	GGCGCGCCTCGACATTTATCCCTTGCGGCGATATAATGTGTGGATAATCC
pos_control_apFAB98	GGCGCGCCAAAAAATTTATTTGCTTTCGCATCTTTTTGTACCTAGATTTAACGTATCCCGA
pos_control_apFAB97	GGCGCGCCAAAAAATTTATTTGCTTTCGCATCTTTTTGTACCCATAATTATTTCATCTTCT
pos_control_apFAB96	GGCGCGCCAAAAAATTTATTTGCTTTCGCATCTTTTTGTACCTATAATAGATTCATTGGCC
pos_control_apFAB95	GGCGCGCCAAAAAATTTATTTGCTTTCGCATCTTTTTGTACCTATAATGTGTGGATAATAA
pos_control_apFAB94	GGCGCGCCAAAAAATTTATTTGCTTTCGCATCTTTTTGTACCATACTTACAGCCATTACTG
pos_control_apFAB93	GGCGCGCCAAAAAATTTATTTGCTTTCAGGAAAATTTTTCTGTAGATTTAACGTATGCCCA
pos_control_apFAB92	GGCGCGCCAAAAAATTTATTTGCTTTCAGGAAAATTTTTCTGCATAATTATTTCATGGAGC
pos_control_apFAB322	GGCGCGCCTTGCGTATTAATCATCCGGCTCGTATAATGTGTGGATGATC
pos_control_apFAB129	GGCGCGCCCACGGTGTTAGACATAAAGTCTAACCTATAGGATACTTACAGCCATGCCGT
pos_control_BBa_J23103	GGCGCGCCCTGATAGCTAGCTCAGTCCTAGGGATTATGCTAGCAGATG
pos_control_BBa_J23105	GGCGCGCCTTTACGGCTAGCTCAGTCCTAGGTACTATGCTAGCAAGGT
pos_control_apFAB78	GGCGCGCCTTGACATTTATCCCTTGCGGCGATAGATTTAACGTATGACGG
pos_control_apFAB130	GGCGCGCCCACGGTGTTAGACATAAAGTCTAACCTATAGGTATAATGTGTGGATCCGTG
pos_control_apFAB134	GGCGCGCCCACGGTGTTAGACAATTAATCATCCGGCTCGATACTTACAGCCATGATTC
pos_control_apFAB339	GGCGCGCCTTGACAATTAATCATCCGGCTCGTAATTTATGTGGATAGGA
pos_control_apFAB338	GGCGCGCCTTGACAATTAATCATCCGGCTCCTAGGATGTGTGGAGGGAC
pos_control_apFAB139	GGCGCGCCCACGGTGTTAGACATCAGGAAAATTTTTCTGATACTTACAGCCATCGACC
pos_control_apFAB85	GGCGCGCCAAAAAATTTATTTGCTTATTAATCATCCGGCTCGTATAATGTGTGGATACCGC
pos_control_apFAB87	GGCGCGCCAAAAAATTTATTTGCTTATTAATCATCCGGCTCGCATAATTATTTCATTGGGG
pos_control_apFAB80	GGCGCGCCAAAAAATTTATTTGCTTTAAAGTCTAACCTATAGGTATAATGTGTGGATACAGA
pos_control_apFAB81	GGCGCGCCAAAAAATTTATTTGCTTTAAAGTCTAACCTATAGGTATAATAGATTCATCTCTT
pos_control_apFAB82	GGCGCGCCAAAAAATTTATTTGCTTTAAAGTCTAACCTATAGGCATAATTATTTCATGGTCC
pos_control_apFAB345	GGCGCGCCTTGACAATTAATCATCCGGCTCGTAGAGTATGTGGAGTATC
pos_control_apFAB342	GGCGCGCCTTGACAATTAATCATCCGGCTCATAAAATTTGTGGAGGCGA
pos_control_apFAB39	GGCGCGCCAAAAAGAGTATTGACTTCAGGAAAATTTTTCTGATACTTACAGCCATTCCAA
pos_control_apFAB38	GGCGCGCCAAAAAGAGTATTGACTATTAATCATCCGGCTCGTAGATTTAACGTATCGGTC
pos_control_apFAB31	GGCGCGCCAAAAAGAGTATTGACTTAAAGTCTAACCTATAGGTATAATAGATTCATAGGGC
pos_control_apFAB30	GGCGCGCCAAAAAGAGTATTGACTTAAAGTCTAACCTATAGGTATAATGTGTGGATCATTG
pos_control_apFAB33	GGCGCGCCAAAAAGAGTATTGACTTAAAGTCTAACCTATAGGTAGATTTAACGTATCTGAT
pos_control_apFAB32	GGCGCGCCAAAAAGAGTATTGACTTAAAGTCTAACCTATAGGCATAATTATTTCATCACTA
pos_control_apFAB36	GGCGCGCCAAAAAGAGTATTGACTATTAATCATCCGGCTCGTATAATAGATTCATTGAAG
pos_control_apFAB140	GGCGCGCCCACGGTGTTAGACATCAGGAAAATTTTTCTGTATAATGTGTGGATGCTTA
pos_control_apFAB149	GGCGCGCCCACGGTGTTAGACATTTATCCCTTGCGGCGAATACTTACAGCCATGTGAA
pos_control_apFAB321	GGCGCGCCTTGACAATTAATCATCCGGCTCGTAACTTATGTGGACTCGG
pos_control_apFAB302	GGCGCGCCTTCCCTTTTAATCATCCGGCTCGTATAATGTGTGGAGACTT
pos_control_apFAB300	GGCGCGCCTTGCCGCTTAATCATCCGGCTCGTATAATGTGTGGATCTTC
pos_control_apFAB323	GGCGCGCCTTGTATTTTAATCATCCGGCTCGTATAATGTGTGGAATCCA
pos_control_apFAB306	GGCGCGCCTTGACAATTAATCATCCGGCTCGTAGTGTTTGTGGATGTTG
pos_control_apFAB317	GGCGCGCCTTGATATTTAATCATCCGGCTCGTATAATGTGTGGAGCACC
pos_control_apFAB311	GGCGCGCCTTGACAATTAATCATCCGGCTCGTAGGTTGTGTGGACGGCT
pos_control_apFAB312	GGCGCGCCTTGACAATTAATCATCCGGCTCTTAGTGTTTGTGGAGCATT
pos_control_apFAB318	GGCGCGCCTTGACTATTAATCATCCGGCTCGTATAATGTGTGGATACAC
pos_control_apFAB29	GGCGCGCCAAAAAGAGTATTGACTTAAAGTCTAACCTATAGGATACTTACAGCCATCCAGC
pos_control_apFAB150	GGCGCGCCCACGGTGTTAGACATTTATCCCTTGCGGCGATATAATGTGTGGATCCATA
pos_control_apFAB259	GGCGCGCCTTCACACTTAATCATCCGGCTCGTATAATGTGTGGACCGCA
pos_control_BBa_J23118	GGCGCGCCTTGACGGCTAGCTCAGTCCTAGGTATTGTGCTAGCCGTCG
pos_control_apFAB58	GGCGCGCCTTGACATAAAGTCTAACCTATAGGTAGATTTAACGTATTCTGA
pos_control_apFAB53	GGCGCGCCAAAAAGAGTATTGACTTTTATCCCTTGCGGCGATAGATTTAACGTATCGGGA
pos_control_apFAB52	GGCGCGCCAAAAAGAGTATTGACTTTTATCCCTTGCGGCGACATAATTATTTCATAGTTC
pos_control_apFAB50	GGCGCGCCAAAAAGAGTATTGACTTTTATCCCTTGCGGCGATATAATGTGTGGATTAACC
pos_control_apFAB57	GGCGCGCCTTGACATAAAGTCTAACCTATAGGCATAATTATTTCATCCGAC
pos_control_apFAB56	GGCGCGCCTTGACATAAAGTCTAACCTATAGGTATAATAGATTCATAGTGA
pos_control_apFAB55	GGCGCGCCTTGACATAAAGTCTAACCTATAGGTATAATGTGTGGATCTGGC
pos_control_apFAB54	GGCGCGCCTTGACATAAAGTCTAACCTATAGGATACTTACAGCCATACAAG
pos_control_lacUV5	GGCGCGCCCCCCAGGCTTTACACTTTATGCTTCCGGCTCGTATAATGTGTGGAATTGTGAGTTGGT
pos_control_apFAB48	GGCGCGCCAAAAAGAGTATTGACTTCGCATCTTTTTGTACCTAGATTTAACGTATTACCA
pos_control_apFAB49	GGCGCGCCAAAAAGAGTATTGACTTTTATCCCTTGCGGCGAATACTTACAGCCATGTAGA
pos_control_BBa_J23116	GGCGCGCCTTGACAGCTAGCTCAGTCCTAGGGACTATGCTAGCAGGAT
pos_control_BBa_J23117	GGCGCGCCTTGACAGCTAGCTCAGTCCTAGGGATTGTGCTAGCCAATC
pos_control_BBa_J23114	GGCGCGCCTTTATGGCTAGCTCAGTCCTAGGTACAATGCTAGCCATAC
pos_control_BBa_J23115	GGCGCGCCTTTATAGCTAGCTCAGCCCTTGGTACAATGCTAGCGCCTG
pos_control_apFAB40	GGCGCGCCAAAAAGAGTATTGACTTCAGGAAAATTTTTCTGTATAATGTGTGGATGTTCA
pos_control_apFAB42	GGCGCGCCAAAAAGAGTATTGACTTCAGGAAAATTTTTCTGCATAATTATTTCATAGGCG
pos_control_BBa_J23119	GGCGCGCCTTGACAGCTAGCTCAGTCCTAGGTATAATGCTAGCACGAA
pos_control_apFAB44	GGCGCGCCAAAAAGAGTATTGACTTCGCATCTTTTTGTACCATACTTACAGCCATGAAGT
pos_control_apFAB45	GGCGCGCCAAAAAGAGTATTGACTTCGCATCTTTTTGTACCTATAATGTGTGGATAGCGG
pos_control_apFAB46	GGCGCGCCAAAAAGAGTATTGACTTCGCATCTTTTTGTACCTATAATAGATTCATTGCTA
pos_control_apFAB47	GGCGCGCCAAAAAGAGTATTGACTTCGCATCTTTTTGTACCCATAATTATTTCATTCACA
pos_control_pTrc*	GGCGCGCCTTGACAATTAATCATCCGGCTCGTATAATGTGTGGAATTGTGAGATGAG
pos_control_pT7A1	GGCGCGCCTCAAAAAGAGTATTGACTTAAAGTCTAACCTATAGGATACTTACAGCCATCGAGAGCTGCG
pos_control_apFAB277	GGCGCGCCTTCCCTATTAATCATCCGGCTCGTATAATGTGTGGAATTTA
pos_control_BBa_J23100	GGCGCGCCTTGACGGCTAGCTCAGTCCTAGGTACAGTGCTAGCTTAAT
pos_control_Nopromoter	GGCGCGCCATTAATCATCCGGAATG
pos_control_BBa_J23102	GGCGCGCCTTGACAGCTAGCTCAGTCCTAGGTACTGTGCTAGCAACCT
pos_control_apFAB79	GGCGCGCCAAAAAATTTATTTGCTTTAAAGTCTAACCTATAGGATACTTACAGCCATAGTCT
pos_control_BBa_J23104	GGCGCGCCTTGACAGCTAGCTCAGTCCTAGGTATTGTGCTAGCTTACG
pos_control_BBa_J23107	GGCGCGCCTTTACGGCTAGCTCAGCCCTAGGTATTATGCTAGCATGGA
pos_control_BBa_J23106	GGCGCGCCTTTACGGCTAGCTCAGTCCTAGGTATAGTGCTAGCGATAG
pos_control_apFAB75	GGCGCGCCTTGACATTTATCCCTTGCGGCGATATAATGTGTGGATAAGTG
pos_control_BBa_J23108	GGCGCGCCCTGACAGCTAGCTCAGTCCTAGGTATAATGCTAGCCACCG
pos_control_apFAB77	GGCGCGCCTTGACATTTATCCCTTGCGGCGACATAATTATTTCATTTTGG
pos_control_apFAB76	GGCGCGCCTTGACATTTATCCCTTGCGGCGATATAATAGATTCATTCCGG
pos_control_apFAB71	GGCGCGCCTTGACATCGCATCTTTTTGTACCTATAATAGATTCATGATGA
pos_control_apFAB70	GGCGCGCCTTGACATCGCATCTTTTTGTACCTATAATGTGTGGATAGAGT
pos_control_apFAB73	GGCGCGCCTTGACATCGCATCTTTTTGTACCTAGATTTAACGTATTCGGC
pos_control_apFAB341	GGCGCGCCTTGACAATTAATCATCCGGCTCGTAATATGTGTGGATGGTT
pos_control_apFAB346	GGCGCGCCTTGACAATTAATCATCCGGCTCGTAATGTTTGTGGATAGCT
pos_control_apFAB109	GGCGCGCCTCGACAATTAATCATCCGGCTCGATACTTACAGCCATCGATT
pos_control_apFAB100	GGCGCGCCAAAAAATTTATTTGCTTTTTATCCCTTGCGGCGATATAATGTGTGGATAGAAC
pos_control_apFAB101	GGCGCGCCAAAAAATTTATTTGCTTTTTATCCCTTGCGGCGATATAATAGATTCATCTTAG
pos_control_apFAB103	GGCGCGCCAAAAAATTTATTTGCTTTTTATCCCTTGCGGCGATAGATTTAACGTATCACGC
pos_control_apFAB104	GGCGCGCCTCGACATAAAGTCTAACCTATAGGATACTTACAGCCATAGCTT
pos_control_PLTETo1	GGCGCGCCTCCCTATCAGTGATAGAGATTGACATCCCTATCAGTGATAGAGATACTGAGCACATCAGCAGTAATT
pos_control_apFAB347	GGCGCGCCTTGACAATTAATCATCCGGCTCTTAATATGTGTGGACGAGG
pos_control_apFAB72	GGCGCGCCTTGACATCGCATCTTTTTGTACCCATAATTATTTCATGCGTC
